############
#...........#
#.#.#######.#
#.#.......#.#
#.#.#####.#.#
#.#.......#.#
..#.#####.#.#
#.#.......#.#
#.#.#####.#.#
#.#.......#..
#.#.#######.#
#############